WWWWWWWWWW
WFFFFWFFFW
WFWFWFFWFW
WFFFFFFFFW
WFFFFFFFFW
WFFFFIFFFW
WFFFFFFFFW
WFFFFFFFFW
WFFFFFFFPW
WWWWWWWWWW